00 00 00 00 00 00 00 00 00 00 00 00 00 00 00 00 00 00 00 00 00 00 00 00
00 00 00 00 00 00 00 00 00 00 00 00 00 00 00 00 00 00 00 00 00 00 00 00
00 00 00 00 10 10 10 00 10 10 10 00 00 10 10 00 10 10 10 00 00 00 00 00
00 00 00 00 00 10 00 00 10 00 00 00 10 00 00 00 00 10 00 00 00 00 00 00
00 00 00 00 00 10 00 00 10 10 00 00 00 10 00 00 00 10 00 00 00 00 00 00
00 00 00 00 00 10 00 00 10 00 00 00 00 00 10 00 00 10 00 00 00 00 00 00
00 00 00 00 00 10 00 00 10 10 10 00 10 10 00 00 00 10 00 00 00 00 00 00
00 00 00 00 00 00 00 00 00 00 00 00 00 00 00 00 00 00 00 00 00 00 00 00
00 00 00 00 00 00 00 00 00 00 00 00 00 00 00 00 00 00 00 00 00 00 00 00
00 00 00 00 00 00 00 00 00 00 00 00 00 00 00 00 00 00 00 00 00 00 00 00
00 00 00 00 00 00 00 00 20 21 00 00 00 00 00 00 00 00 31 00 00 00 00 17
00 30 00 00 00 00 00 00 00 00 00 00 00 00 00 00 00 00 02 00 17 19 00 14
00 01 00 00 00 00 00 00 00 00 00 00 00 03 00 00 03 00 17 18 15 16 00 14
18 19 00 00 00 17 18 18 18 18 18 18 18 18 18 18 18 18 15 15 15 15 18 15
15 15 18 19 00 14 15 15 15 15 15 15 15 15 15 15 15 15 15 15 15 15 15 15
15 15 15 16 00 14 15 15 15 15 15 15 15 15 15 15 15 15 15 15 15 15 15 15
15 15 15 16 00 14 15 15 15 15 15 15 15 15 15 15 15 15 15 15 15 15 15 15
15 15 15 16 00 14 15 15 15 15 15 15 15 15 15 15 15 15 15 15 15 15 15 15


00 00 00 00 00 00 00 00 00 00 00 00 00 00 00 00 00 00 00 00 00 00 00 00
00 00 00 00 00 00 00 00 00 00 00 00 00 00 00 00 00 00 00 22 00 00 00 00
00 00 00 00 00 00 10 00 00 00 00 00 00 00 00 00 00 10 00 24 00 00 00 00
00 00 00 10 00 00 00 00 00 00 10 00 00 00 10 00 00 00 00 24 00 00 00 00
00 00 00 00 00 00 00 00 00 00 00 00 00 00 00 00 00 00 00 24 00 00 31 00
18 19 00 00 00 00 00 00 00 00 00 00 00 00 00 00 00 00 00 24 00 00 02 00
15 15 21 00 20 25 25 25 25 25 25 25 25 25 25 25 25 25 25 12 25 18 18 18
15 16 00 00 03 00 00 00 00 00 00 00 00 00 00 00 00 00 00 00 00 14 15 15
15 15 18 25 25 25 25 25 25 25 25 25 25 25 25 25 25 25 25 21 00 11 15 15
15 15 16 00 00 00 00 00 00 00 00 00 00 00 00 00 00 00 00 00 03 00 14 15
15 15 13 00 20 25 25 25 25 25 25 25 25 25 25 25 25 25 25 25 25 18 15 15
15 16 00 00 03 00 00 00 00 00 00 00 00 00 00 00 00 00 00 00 00 14 15 15
12 12 25 25 25 25 18 18 18 18 18 18 18 18 18 19 00 00 00 00 00 14 15 15
00 30 00 00 00 00 11 12 12 12 12 12 12 12 12 12 25 25 25 21 00 11 15 15
00 01 00 00 00 00 00 00 00 00 00 00 00 00 00 00 00 00 00 03 00 00 14 15
18 18 18 18 18 18 18 18 18 18 18 18 18 18 18 18 18 18 18 18 18 18 15 15
15 15 15 15 15 15 15 15 15 15 15 15 15 15 15 15 15 15 15 15 15 15 15 15
15 15 15 15 15 15 15 15 15 15 15 15 15 15 15 15 15 15 15 15 15 15 15 15

00 00 00 00 00 00 00 00 00 00 00 00 00 00 00 00 00 00 00 00 00 00 00 00
00 00 00 00 00 00 00 00 00 00 00 00 00 00 00 00 00 00 00 00 00 00 00 00
00 00 00 00 00 00 00 00 00 00 00 00 00 00 00 00 00 00 00 00 00 00 00 00
00 00 00 00 00 00 00 00 00 00 00 00 00 00 00 00 00 00 00 00 00 00 00 00
00 00 00 00 00 00 00 00 00 00 00 00 00 00 00 00 00 00 00 00 00 00 00 00
00 00 00 00 00 00 03 00 00 00 00 00 00 22 00 00 22 00 00 00 00 00 00 00
00 00 00 00 00 20 21 00 00 00 00 00 00 24 00 00 14 19 00 00 00 31 00 00
00 00 00 22 00 00 00 00 00 00 00 00 00 24 00 00 14 16 00 00 00 02 00 00
00 00 17 15 18 18 18 18 18 18 18 18 18 16 00 00 14 15 18 18 18 18 18 18
10 00 11 12 12 12 12 12 12 12 12 12 12 13 00 00 14 15 15 15 15 15 15 15
00 00 00 00 00 00 00 00 00 00 00 00 00 00 00 00 14 15 15 15 15 15 15 15
18 18 18 18 18 18 18 18 18 18 18 25 25 19 00 00 14 15 15 15 15 15 15 15
12 12 12 12 12 12 12 12 12 15 13 00 00 11 21 00 14 15 15 15 15 15 15 15
00 30 00 00 00 00 00 00 00 23 00 00 00 00 00 00 14 15 15 15 15 15 15 15
00 01 00 00 00 00 00 00 00 03 00 00 00 00 03 00 14 15 15 15 15 15 15 15
18 18 18 18 18 18 18 18 18 18 19 00 00 17 18 18 15 15 15 15 15 15 15 15
15 15 15 15 15 15 15 15 15 15 16 00 00 14 15 15 15 15 15 15 15 15 15 15
15 15 15 15 15 15 15 15 15 15 16 00 00 14 15 15 15 15 15 15 15 15 15 15

15 15 15 15 15 15 15 15 15 15 15 15 16 00 00 00 00 00 00 00 14 15 15 15
15 12 12 12 12 12 12 12 12 12 15 15 16 00 00 00 00 00 00 00 14 15 15 15
13 00 00 00 00 00 00 00 00 00 11 15 16 00 00 00 00 00 00 00 14 15 15 15
00 00 00 00 00 00 00 00 00 00 00 11 16 00 00 00 00 00 00 00 14 15 15 15
00 00 00 00 00 00 00 00 00 00 00 00 23 00 00 00 00 00 00 00 14 15 15 15
00 00 22 00 00 03 00 00 00 00 00 00 00 00 00 00 00 00 00 00 11 15 15 15
00 00 11 25 25 25 21 00 00 00 00 00 00 00 00 00 00 00 00 00 00 11 12 12
00 00 00 00 00 00 00 00 00 00 00 00 22 00 00 00 00 00 00 00 00 00 00 00
00 00 00 00 00 03 00 00 00 00 00 00 24 00 00 00 00 00 00 00 00 00 31 00
00 00 00 00 20 25 25 25 25 25 25 25 13 00 00 00 00 00 00 00 00 00 02 00
00 00 00 00 00 00 00 00 00 00 00 00 00 00 00 00 00 00 00 00 00 17 18 18
10 00 30 00 00 00 00 00 00 00 00 00 00 00 00 00 00 00 00 00 17 15 15 15
00 00 01 00 00 03 00 00 00 00 00 03 00 00 03 00 00 00 00 00 14 15 15 15
18 18 19 00 17 19 00 17 18 18 18 19 00 17 19 00 00 00 00 00 14 15 15 15
15 15 15 18 15 15 18 15 15 15 15 15 18 15 15 18 19 00 00 00 14 15 15 15
15 15 15 15 15 15 15 15 15 15 15 15 15 15 15 15 16 00 00 00 14 15 15 15
15 15 15 15 15 15 15 15 15 15 15 15 15 15 15 15 16 00 00 00 14 15 15 15
15 15 15 15 15 15 15 15 15 15 15 15 15 15 15 15 16 00 00 00 14 15 15 15

00 00 00 00 00 00 00 00 00 00 00 00 00 00 00 00 00 00 00 00 00 00 00 00
00 00 00 00 00 00 00 00 00 00 00 00 00 00 00 00 00 22 00 00 00 00 00 00
00 00 00 00 00 00 00 22 00 00 00 00 00 00 00 00 00 24 00 00 00 00 00 00
00 00 00 00 00 00 00 24 00 00 00 00 00 00 00 00 00 24 00 00 00 00 00 00
00 00 00 00 00 00 00 24 00 00 00 00 00 00 00 03 00 24 00 00 00 00 00 00
00 00 00 00 00 03 00 24 00 00 00 00 00 00 20 21 00 24 00 00 00 00 00 00
00 00 00 00 20 21 00 24 00 00 00 10 00 00 00 00 00 24 00 00 00 00 00 00
00 10 00 00 00 00 00 23 00 00 00 00 00 00 00 00 00 23 00 00 00 00 00 00
00 00 00 00 00 00 00 00 00 00 00 00 00 10 00 00 00 00 00 00 00 00 00 00
00 00 00 10 00 00 00 00 00 00 00 00 00 00 00 00 00 00 00 00 00 00 00 00
00 00 10 00 00 00 00 00 00 00 10 00 00 00 00 00 00 00 00 00 00 00 31 00
00 00 00 00 00 00 00 00 00 00 00 00 00 00 00 00 00 00 00 00 00 00 02 00
10 00 00 00 00 00 00 00 00 00 00 00 10 00 00 00 00 00 00 00 00 20 25 21
00 00 00 00 00 00 00 00 00 00 00 00 00 00 00 00 00 00 00 00 00 00 00 00
00 30 00 10 00 00 00 00 00 00 00 10 00 00 00 00 00 00 00 00 00 00 00 00
00 01 00 00 00 00 00 00 00 00 00 00 00 00 00 20 25 25 25 25 25 25 21 00
00 10 00 00 00 00 10 00 00 00 00 00 00 10 00 00 00 00 00 00 00 00 00 00
00 00 00 00 00 00 00 00 00 00 00 00 00 00 00 00 00 00 00 00 00 00 00 00

00 00 00 00 00 11 12 15 15 15 15 15 15 15 15 15 15 15 15 15 15 15 15 15
00 00 00 00 00 00 00 11 15 15 15 15 15 15 15 15 15 15 15 15 15 15 15 15
00 00 00 00 00 00 00 00 11 15 15 15 12 12 12 12 12 15 15 15 15 15 15 15
00 00 00 00 00 00 00 00 00 14 15 16 00 00 00 00 00 11 12 12 15 15 15 15
00 00 00 00 00 00 00 00 00 11 15 13 00 00 00 00 00 00 00 00 11 15 15 15
00 00 00 00 00 00 00 00 00 00 24 00 00 00 00 00 00 00 00 00 00 14 15 15
00 00 00 00 00 00 00 00 00 00 23 00 00 00 00 00 00 00 00 00 00 11 15 15
00 00 00 00 00 00 00 00 00 00 00 00 00 00 00 00 00 00 00 00 00 00 14 15
00 00 30 00 00 00 00 00 00 00 00 00 00 00 00 00 00 00 31 00 00 00 14 15
00 00 01 00 00 00 00 00 03 00 00 00 00 00 00 00 00 00 02 00 00 00 14 15
18 18 18 18 18 18 18 18 19 00 00 00 00 20 18 18 18 18 18 18 18 18 15 15
15 15 15 15 15 15 15 15 13 00 00 00 00 00 11 15 15 15 15 15 15 15 15 15
15 15 15 15 15 15 15 13 00 00 00 00 00 00 00 00 11 15 15 15 15 15 15 15
15 15 15 15 15 15 13 00 00 00 00 00 00 00 00 00 00 11 15 15 15 15 15 15
15 15 15 15 15 13 00 00 00 00 00 00 00 00 00 00 00 00 11 12 15 15 15 15
15 15 15 15 13 00 00 00 00 00 00 00 00 00 00 00 00 00 00 00 14 15 15 15
15 15 15 13 00 00 00 00 00 00 00 00 00 00 00 00 00 00 00 00 11 15 15 15
15 15 16 00 00 00 00 00 00 00 00 00 00 00 00 00 00 00 00 00 00 14 15 15
