00 00 00 00 00 00 00 00 00 00 00 00 00 00 00 00 00 00 00 00 00 00 00 00
00 00 00 00 00 00 00 00 00 00 00 00 00 00 00 00 00 00 00 00 00 00 00 00
00 00 00 00 00 00 00 00 00 00 00 00 00 00 00 00 00 00 00 00 00 00 00 00
00 00 00 00 00 00 00 00 00 00 00 00 00 00 00 00 00 00 00 00 00 00 00 00
00 00 00 00 00 00 00 00 00 00 00 00 00 00 00 00 00 00 00 00 00 00 00 00
00 00 00 00 00 00 00 00 00 00 00 00 00 00 00 00 00 00 00 00 00 00 00 00
00 00 00 00 00 00 04 00 00 00 00 00 00 01 00 00 01 00 00 00 00 00 00 00
00 00 00 00 00 01 01 00 00 00 00 00 00 01 00 00 01 01 00 00 00 06 00 00
00 00 00 01 00 00 00 00 00 00 00 00 00 01 00 00 01 01 00 00 00 03 00 00
01 00 01 01 01 01 01 01 01 01 01 01 01 01 00 00 01 01 01 01 01 01 01 01
00 00 00 00 00 00 00 00 00 00 00 00 00 00 00 00 01 01 01 01 01 01 01 01
01 01 01 01 01 01 01 01 01 01 01 01 01 01 00 00 01 01 01 01 01 01 01 01
01 01 01 01 01 01 01 01 01 01 01 00 00 01 01 00 01 01 01 01 01 01 01 01
00 05 00 00 00 00 00 00 00 01 00 00 00 00 00 00 01 01 01 01 01 01 01 01
00 02 00 00 00 00 00 00 00 04 00 00 00 00 04 00 01 01 01 01 01 01 01 01
01 01 01 01 01 01 01 01 01 01 01 00 00 01 01 01 01 01 01 01 01 01 01 01
01 01 01 01 01 01 01 01 01 01 01 00 00 01 01 01 01 01 01 01 01 01 01 01
01 01 01 01 01 01 01 01 01 01 01 00 00 01 01 01 01 01 01 01 01 01 01 01
