00 00 00 00 00 00 00 00 00 00 00 00 00 00 00 00 00 00 00 00 00 00 00 00
00 00 00 00 00 00 00 00 00 00 00 00 00 00 00 00 00 00 00 00 00 00 00 00
00 10 00 12 00 14 00 16 00 18 00 20 00 22 00 24 00 00 00 00 00 00 00 00
00 00 11 00 13 00 15 00 17 00 19 00 21 00 23 00 25 00 00 00 00 00 03 00
00 00 00 00 00 00 00 00 00 00 00 00 00 00 00 00 00 00 00 00 00 00 00 00
00 00 00 00 00 00 00 00 00 00 00 00 00 00 00 00 00 00 00 00 00 00 00 00
00 00 00 00 00 00 00 00 00 00 00 00 00 00 00 00 00 00 00 00 00 00 00 00
00 00 00 00 00 00 00 00 00 00 00 00 00 00 00 00 00 00 00 00 00 00 00 00
00 00 00 00 00 00 00 00 00 00 00 00 00 00 00 00 00 00 00 00 00 00 00 00
00 00 00 00 00 00 00 00 00 00 00 00 00 03 00 00 00 00 00 00 00 00 00 00
00 00 00 00 00 00 00 00 00 00 00 00 00 00 00 00 00 00 00 00 00 00 00 17
00 10 00 00 00 00 00 00 00 00 00 00 00 00 00 00 00 00 00 00 17 19 00 14
00 00 00 00 00 00 00 00 00 01 00 00 00 03 00 00 03 00 02 00 14 16 00 14
18 19 00 00 00 17 18 18 18 18 18 18 18 18 18 18 18 18 18 18 15 15 18 15
15 15 18 19 00 14 15 15 15 15 15 15 15 15 15 15 15 15 15 15 15 15 15 15
15 15 15 16 00 14 15 15 15 15 15 15 15 15 15 15 15 15 15 15 15 15 15 15
15 15 15 16 00 14 15 15 15 15 15 15 15 15 15 15 15 15 15 15 15 15 15 15
15 15 15 16 00 14 15 15 15 15 15 15 15 15 15 15 15 15 15 15 15 15 15 15


00 00 00 00 00 00 00 00 00 00 00 00 00 00 00 00 00 00 00 00 00 00 00 00
00 00 00 00 00 00 00 00 00 00 00 00 00 00 00 00 00 00 00 00 00 00 00 00
00 00 00 00 00 00 00 00 00 00 00 00 00 00 00 00 00 00 00 00 00 00 00 00
00 00 00 00 00 00 00 00 00 00 00 00 00 00 00 00 00 00 00 00 00 00 00 00
00 00 00 00 00 00 00 00 00 00 00 00 00 00 00 00 00 00 00 00 00 00 00 00
00 00 00 00 00 00 03 00 00 00 00 00 00 22 00 00 22 00 00 00 00 00 00 00
00 00 00 00 00 20 21 00 00 00 00 00 00 24 00 00 14 19 00 00 00 31 00 00
00 00 00 22 00 00 00 00 00 00 00 00 00 24 00 00 14 16 00 00 00 02 00 00
00 00 17 15 18 18 18 18 18 18 18 18 18 16 00 00 14 15 18 18 18 18 18 18
10 00 11 12 12 12 12 12 12 12 12 12 12 13 00 00 14 15 15 15 15 15 15 15
00 00 00 00 00 00 00 00 00 00 00 00 00 00 00 00 14 15 15 15 15 15 15 15
18 18 18 18 18 18 18 18 18 18 18 25 25 19 00 00 14 15 15 15 15 15 15 15
12 12 12 12 12 12 12 12 12 15 13 00 00 11 21 00 14 15 15 15 15 15 15 15
00 30 00 00 00 00 00 00 00 23 00 00 00 00 00 00 14 15 15 15 15 15 15 15
00 01 00 00 00 00 00 00 00 03 00 00 00 00 03 00 14 15 15 15 15 15 15 15
18 18 18 18 18 18 18 18 18 18 19 00 00 17 18 18 15 15 15 15 15 15 15 15
15 15 15 15 15 15 15 15 15 15 16 00 00 14 15 15 15 15 15 15 15 15 15 15
15 15 15 15 15 15 15 15 15 15 16 00 00 14 15 15 15 15 15 15 15 15 15 15


00 00 00 00 00 00 00 00 00 00 00 00 00 00 00 00 00 00 00 00 00 00 00 00
00 00 00 00 00 00 00 00 00 00 00 00 00 00 00 00 00 00 00 00 00 00 00 00
00 00 00 00 00 00 00 00 00 00 00 00 00 00 00 00 00 00 00 00 00 00 00 00
00 00 00 00 00 00 00 00 00 00 00 00 00 00 00 00 00 00 00 00 00 00 00 00
00 00 00 00 00 00 00 00 00 00 00 00 00 00 00 00 00 00 00 00 00 00 00 00
00 00 00 00 00 00 00 00 00 00 00 00 00 00 00 00 00 00 00 00 00 00 00 00
00 00 00 00 00 00 00 00 00 00 00 00 00 00 00 00 00 00 00 00 00 00 00 00
00 00 00 00 00 00 00 00 00 00 00 00 00 00 00 00 00 00 00 00 00 00 00 00
00 00 00 00 00 00 00 00 00 00 00 00 00 00 00 00 00 00 00 00 00 00 00 00
00 00 00 00 00 00 00 00 00 00 00 00 00 00 00 00 00 00 00 00 00 00 00 00
00 00 00 00 00 00 00 00 00 00 00 00 00 00 00 00 00 00 00 00 00 00 00 17
00 03 00 00 00 00 00 00 00 00 00 00 00 00 00 00 00 00 00 00 17 19 00 14
00 00 00 00 00 00 00 00 00 01 00 00 00 03 00 00 03 00 02 00 14 16 00 14
18 19 00 00 00 17 18 18 18 18 18 18 18 18 18 18 18 18 18 18 15 15 18 15
15 15 18 19 00 14 15 15 15 15 15 15 15 15 15 15 15 15 15 15 15 15 15 15
15 15 15 15 18 15 15 15 15 15 15 15 15 15 15 15 15 15 15 15 15 15 15 15
15 15 15 15 15 15 15 15 15 15 15 15 15 15 15 15 15 15 15 15 15 15 15 15
15 15 15 15 15 15 15 15 15 15 15 15 15 15 15 15 15 15 15 15 15 15 15 15

